国中	初中
國中	初中
中學	初中
大陸	台湾
香港、澳門、中國大陸	台湾
中國大陸及港澳	台湾
港澳	台湾
臺灣	香港
中國大陸和台灣	香港
香港	中國大陸
上海	谍海风云
發展	進程
建立	创建
行向量	列向量
刀鋒	刀片
分數	分值
分割	分区
崩潰	击穿
的處理程序	進程
利用	通過
全面進化	通関大作战
辭世	逝世
走訪	遍历
越冬	過冬
法寶	道具
遵循	遵从
零件	部件
倉位	部位
展开	铺开
西米谷	锡米瓦利
搜魔	锡蒙力
龍之心	锦绣华南
輸入	键入
鍵盤	键帽
映像	镜像
騎槍	長矛
鎖存器	闩锁
鋼琴師	闪亮的风采
閃塵	闪尘
閃靈	闪灵
鬼店	闪灵
優格	酸奶
优格	酸奶
優酪乳	酸奶
草莓	酸莓
抱歉	道歉
舉世盛名	名誉
舉世盛名	名譽
那天以後	之后
於中國大陸稱	于台湾称作
大清總督于成龍	于成龙
（北韓）之間	之间
（北韩）之间	之间
"列"
(折合港幣約2.3億元）
--脬
1985年阿根廷
1世代	单向组合
1公尺	1米
1楼	2楼
1樓	2楼
2樓	2楼
1985年阿根廷	阿根廷，1985
2.0版前名为Workflow	2.0版前名为Workflow，2.1.3版前名为捷径
3D模型	三维模型
Bing工具欄	必应工具栏
Epcot，或新世紀樂園	新纪元乐园（）
GAL系	辣妹
K線	阴阳烛
Q彈	弹牙
KGB	克格勃
“KGB”（КГБ）	“克格勃”（КГБ）
Visa卡	维萨卡
“主動”	“主动”或“有源”
“剪刀”、“石头”或“布”	“石头”、“剪子”或“布”
TIGER×DRAGON！	TIGER×DRAGON！龙与虎
Toll樣受體	類鐸受體
Retina顯示器	Retina显示屏
一個	一盘
一條	一座
職權	职能
相關	联动
聯盟	联合会
聯會	联合会
總會	联合会
丁組	丁级
丁達爾效應	廷得耳效应
一般	一般般
一天	每日
一次性筷子	衛生筷
一班	一群
一等獎	特别优异

三氯松	敌百虫
三等獎	荣誉
三角洲	德尔它
三更半夜	下班后
三文魚	鲑鱼
三個火槍手	三剑客
七龍珠超	龍珠超
七龍珠：全新進化	七龙珠
七段顯示器	七劃管
英皇	国王
上升一倍	翻了一番
上伏塔	上沃尔特
上一頁	后退
上一頁、下一頁	前进/后退
Mezzala	伪边锋
《IKEA型錄》	《宜家家居指南》
《IKEA產品目錄》	《IKEA型录》
作轉運站、	作公共运输交汇处、 作转运站、
傘弄蝶屬	伞弄蝶属 暮弄蝶属
保方	布冯 詹路易吉·布冯
佳得樂	佳得乐 开特力
傳統市場	传统市场 街市
傳統鐵路	既有线 既有线路
儀仗隊	仪仗队
儀隊	仪队
兔寶寶	兔八哥 兔巴哥
稀有氣體	惰性气体 高贵气体
電漿	电浆 等离子体
等離子體	电浆 等离子体
電腦	电子计算机
計算機	计算器 计算机
計畫	工程 计划 项目 项目计划
製程	制造工艺 物理实现工艺
網友	网友
網民	网友
網絡	互联网 网络
蝦片	虾片 虾饼
蝦餅	虾片 虾饼
奇異果	奇异果
獼猴桃	奇异果 猕猴桃
注音符號的「--  」	汉语拼音的“a”
注音符號的「--  」	汉语拼音的“i”
注音符號的「--  」	汉语拼音的“u”
注音符號的「--  」	汉语拼音的“yu”
爆發	暴发 爆发
資訊	信息 数据
華夫餅	格子松饼 窝夫
莫麗琪	妮古拉·安·摩根 摩根
文件	文档 文檔
檔案	文件 档案
體育場	体育场 大球场
高級	高档 高檔
鷹鵰	熊鹰 角鹰
質素	質量 质量
品質	質量 质量
麻將	麻将 麻雀
麻省	马萨诸塞 马萨诸塞州
默認    默认
預設	默认
製冷劑	冷媒 雪种
可持續性	可持续性 永续性
民營化	民营化 私有化
水華	富营养 富营养化
Lucky	吉祥 小猫吉祥
ce1	suông suāinn
公共運輸	公共交通 公共运输、大众运输
馬習會	习马会 马习会
辜汪會談	汪辜会谈 辜汪会谈
汪辜會談	汪辜会谈 辜汪会谈
德意志邦聯（）	德意志邦联（）
藤原效應	双台风效应 藤原效应
摩爾紋	摩尔纹 莫列波纹
柏青哥	弹子球游戏 弹珠机
監製	制作 制作人
圖片	图像 平面图像
外籍勞工	外地劳工 外籍劳工
迴形針	万字夹 回纹针
童話鎮	童话镇 童話小镇
路線	交路 路线交路
踩過界	盲侠大律师 踩过界
粵語	國語 粤语
救援突擊隊	小松鼠歷險記 救難小福星
文化創意產業	文化创意产业 文化及创意产业
文化及創意產業	文化创意产业 文化及创意产业
心裡全是你	因为我有你 zh-hk:心裡全是你
心裡全是你	心里全是你
快閃族	快闪党 快闪族
快閃黨	快闪党 快闪族
巴士	公共汽车 客车
朝鮮	中朝 朝方
韓國	朝鲜 韩国
測試人員	会员 预览体验
因為我有你	因为我有你 zh-hk:心裡全是你
因為我有你	心里全是你
大球場	体育场 大球场
大蛇	大毒蛇 沙彼多
專案	項目 项目
C&amp	停終 停終信函
电脑	电子计算机 计算机
參政司	参政司 驻扎官
均勻連續	一致连续 均匀连续
強化子	增强子 强化子
德仔	三夫 须羽三夫
珠光寶氣	第凡內早餐 蒂凡尼早餐
瓦爾登湖	瓦尔登湖 湖滨散记
祖伯	德鲁叔叔 德鲁大叔
神奇寶貝	宝可梦 精灵宝可梦
神龍特攻隊	机动装甲突击队 蒙面斗士
空中情緣	梦想飞行 梦想飞行Good Luck
空服員	乘务员 空中乘务员
星空奇遇記	星际旅行：原初系列 星际迷航
星艦奇航記	星际旅行 星际迷航
星際爭霸戰	星际旅行：原初系列 星际迷航
無懼的愛	放手去爱
美麗傳說	民间故事
油車水鎮	水箱温泉镇
油车水镇	水箱温泉镇
機器勇士	倍功夫 機器戰神：機器勇士
盲俠大律師	盲侠大律师 踩过界
法國文化協會	法国文化协会 法语联盟
中央	中部
前鋒	中锋
中模	中毛
午夜黑	丹青黑
宿主	主机
家機	主机
主板	主机板
主機板	主板
底版	主板
主角	主角所驾的巨大机器人
主唱	主音歌手
系列	主题
樂節	乐节
樂團	乐队
樂隊	乐队
樂高	乐高
樂劇專業	乐剧专业
樂動魔方	乐动魔方
乐队	乐团
佐敦	乔丹
中華	中华台北
中國中央電視台高清頻道	中国中央电视台高清频道
中國大陸	中国內地
中國內地	中国內地
中國	中国大陆
內地	大陆
中国	大陆
大陆	港台
增強子	增强子 强化子
劉闢	刘辟 劉辟
App世代	应用兽 应用兽系列
聯絡	联系
關聯	联系
偶像	某偶像的
科學	某科学的